10,10,10,10,10,10,10,10,10,10,0,0,10,10,10,0,0,10,10,10,10,10,10,10,10,10,10
10,1,1,5,1,1,1,1,1,10,0,0,10,0,10,0,0,10,1,1,5,10,10,1,1,1,10
10,1,10,10,10,1,10,10,1,10,0,0,10,0,10,0,0,10,1,10,1,10,10,1,10,1,10
10,1,10,0,10,1,10,10,1,10,0,0,10,0,10,0,0,10,1,10,1,1,1,1,10,1,10
10,1,10,10,10,1,10,10,1,10,10,10,10,0,10,10,10,10,1,10,10,10,10,1,10,1,10
10,1,1,1,1,1,1,1,1,1,1,1,1,1,1,1,1,1,1,1,1,1,1,1,10,1,10
10,1,10,10,10,1,10,10,10,10,10,10,10,0,10,10,10,10,1,10,1,10,10,10,10,1,10
10,1,10,0,10,1,1,1,1,10,0,0,0,0,0,0,0,0,1,10,1,1,1,1,10,1,10
10,1,10,10,10,1,10,10,1,10,0,10,10,10,10,0,10,10,1,10,1,10,10,1,10,1,10
10,1,1,1,1,1,10,10,1,0,0,10,0,0,10,0,10,10,1,1,1,10,10,1,1,1,10
10,10,10,10,10,1,10,10,10,10,0,0,0,0,10,0,10,10,10,10,0,10,10,10,10,1,10
10,1,1,1,1,1,10,10,1,0,0,10,0,0,10,0,10,10,1,1,1,10,10,1,1,1,10
10,1,10,10,10,1,10,10,1,10,0,10,10,10,10,0,10,10,1,10,1,10,10,1,10,1,10
10,1,10,0,10,1,1,1,1,10,0,0,0,0,0,0,0,0,1,10,1,1,1,1,10,1,10
10,1,10,10,10,1,10,10,10,10,10,10,10,0,10,10,10,10,1,10,1,10,10,10,10,1,10
10,1,1,1,1,1,1,1,1,1,1,1,1,1,1,1,1,1,1,1,1,1,1,1,10,1,10
10,1,10,10,10,1,10,10,1,10,10,10,10,0,10,10,10,10,1,10,10,10,10,1,10,1,10
10,1,10,0,10,1,10,10,1,10,0,0,10,0,10,0,0,10,1,10,1,1,1,1,10,1,10
10,1,10,10,10,1,10,10,1,10,0,0,10,0,10,0,0,10,1,10,1,10,10,1,10,1,10
10,1,1,5,1,1,1,1,1,10,0,0,10,0,10,0,0,10,1,1,5,10,10,1,1,1,10
10,10,10,10,10,10,10,10,10,10,0,0,10,10,10,0,0,10,10,10,10,10,10,10,10,10,10
